AAA	Lysine
AAC	Asparagine
AAG	Lysine
AAT	Asparagine
ACA	Threonine
ACC	Threonine
ACG	Threonine
ACT	Threonine
AGA	Arginine
AGC	Serine
AGG	Arginine
AGT	Serine
ATA	Isoleucine
ATC	Isoleucine
ATG	Methionine
ATT	Isoleucine
CAA	Glutamine
CAC	Histidine
CAG	Glutamine
CAT	Histidine
CCA	Proline
CCC	Proline
CCG	Proline
CCT	Proline
CGA	Arginine
CGC	Arginine
CGG	Arginine
CGT	Arginine
CTA	Leucine
CTC	Leucine
CTG	Methionine
CTT	Leucine
GAA	Glutamicacid
GAC	Asparticacid
GAG	Glutamicacid
GAT	Asparticacid
GCA	Alanine
GCC	Alanine
GCG	Alanine
GCT	Alanine
GGA	Glycine
GGC	Glycine
GGG	Glycine
GGT	Glycine
GTA	Valine
GTC	Valine
GTG	Valine
GTT	Valine
TAA	Stop
TAC	Tyrosine
TAG	Stop
TAT	Tyrosine
TCA	Serine
TCC	Serine
TCG	Serine
TCT	Serine
TGA	Stop
TGC	Cysteine
TGG	Tryptophan
TGT	Cysteine
TTA	Leucine
TTC	Phenylalanine
TTG	Methionine
TTT	Phenylalanine